"brain trust" - a group of experts appointed to advise a government or politician.
abundant - обильный
abus'd *
accidentally - случайно
accountant - бухгалтер
ache - боль (headache, stomuchache???)
acquaintance знакомство, знакомый, знакомое
across - вбок?
acting in a way it shouldn't - вести себя так, как недолжно
acute острый
adhere - придерживаться, прилипать
admire - восхищаться
admitt - признавать
advent - приход, пришествие
affair дело роман связь
affairs *
afford - позволить  ( о деньгах, я не могу позволить себе приобрести гитару и т.д.)
ahern - кхм!
ajar - полуоткрытый
Alas - увы
allow - позволять
amazement - потрясение
amber - янтарь
amuse - веселить
angrily - злобно
ankle - щиколотка
annoying - утомительный
anticipating *
anxious - тревожный
apart from somebody - окромя кого-либо
apologize - извиняться
Apothecary - аптека
appear - появлятся
appearance - облик
appreciate *
appreciation признание оценка понимание
approve - одобрять
approvingly - одобрительно disapprovingly - неодобрительно
arcane мистический тайный
argue - спорить
armpit - подмышка
arrive - прибывать
arrogant высокомерный
as far apart as - столь отдаленные как 
ash - пепел
askew - сбивать прочь
assume полагать, допускать; брать на себя
assumption предположение, допущение; вступление, присвоение
astonishing - удивительные
astounding - поразительный
astride - верхом (садиться)
attend посещать, прислуживать, заботиться
attract - привлекать
avarice *
awake - бодро
award - приобретать, получить ( cup for example )
awarness *
awkwardly - неловко
babble - гомон
badge - значок (приколотый на груди)
badger - барсук
baffling impossible to understand затруднительный
bake - печь
bakery - булочная
balls of string - железный шарик
bandages - бинты
bang - долбить ( bang! bang! (C) )
bangs - челка 
banquet - банкет
banter подшучивать
barber - парикмахерская
barely - едва
bark - гавкнуть ( рально собачий лай )
barr - преграждать
bartender  - бармен
basket - корзина ( wastepaper basket - корзина для бумаг )
bate - затаить
batter -потрепать
batty - трухлявый
baw - орать
be bound - were bound - были вынуждены ("приперты к стенке")
beady - бусинка
beady-eyed - востроглазый
beak - клюв
beam - сият
beard - борода
beckon - потащить
beechwood - бук
beet - свекла
befuddle - поразить
begg - умолять
behead - обезглавить bearm?? beleg??
being downright - стать закоренелым, полным (атеистом, прагматиком и т.д.)
belligerent воинственный воюющая сторона
belong - записаться
bemuse смутить озадачить
bend - нагнуться, согнуть
benevolence - доброжелательный, благожелательность
bewilde - замешкаться
biase - предвзято относиться 
bill - счеи купюра
billow - развеваться (одежда, флаг, клубы дыма)
bit - прикусить надкусить
bitter wind - ледяной ветер
bitterly - горько, ядовито
blame - осуждать
blanket - одеяло
blast - свист
blaste - проклинать
blatant (of bad behavior) done openly and unashamedly. вопиющий бесстыдный
Blimey - черт подери
blossom - выдувать
blundering - бестолковый
blurted out - вырвалось у 
blush - краснеть
board - бревно
boarded-up - заколоченный, забаррикадированный
boarhound - волкодав
boast - хвастать
boast хвастовство, хвалиться
bobb - бултыхаться
bogies - сопли
boil - варить
bond связь, оковы, закладная, скрепа
bonfire - костер
bonnet - чепчик
booger - сопля
borrow - одалживать (просить в долг)
bother - возиться
boulder - булыжник
bowl - миска, банка
branch - ветка
brandishe - махать ( тряпкой для сбора пыли ?? )
brass - бронзовый
breed - выращивание
brew - приготовить
briefcase - портфель
brim - поля шляпы
briskly - бодро, живо
brood - расстраиваться
broomstick - метла
brought - взмахнуть, поднять, нести
buck - сбросить somebody off
bucket - //ведро навряд...
buckle - подогнуть (коленки)
buckle - пряжка
budge - шелохнуться
buffalo - бык
bulg - выпучивать
bull - обижать
bump - ткнуться
bun - булочка, (пучок волос (о волосах)
bunch - кучка
bundle - куча (сверток)
bungler - растяпа?
bure - закапывать, хоронить
burly - крупный
burnished - потемневший
burst - врываться
bushy - спутанно
bustling - шумный
by the time - в товремя как
cabbage - капуста
cackle - мерзко хихикать
cadenced ритмичный
calamity - бедствие
calmly - спокойно
candid прямой искренний
cane - розга
canter - скакать
caretaker - коммендант
carriage - вагон
carry on - бороться
caster - диктор
casually - обычно, небрежно
cauldron - котел
caution - предосторожность
ceas - стихать
celebrity - знаменитость
cereal - каша, крупа
chase - погоня
chaser - нападающий
cheek - щека, нахальство
cheer - оптимизм
chessmen - шахматные фигурки
chestnut - лошадиный
chew - жевать
chill - охлаждать
chilly - холодный
chime - пробить ( о часах - пробить полночь )
chimney - печная труба
chipp - отбить, подбить
choking - ужастный, шокирующий?
chopp - посыпать
chorus - сказать хором
chuckle - довольно со смешком сказать
circumstance  - обтоятельство
clamber - вскорабкиваться
clamp - схватить, зажать
clarificate проянять осветлять
clasp - прижать
clatter - позвякивать
clench - сжимать
click - щелкать
cliff - утес
clink - позвякивать
clobb - терпеть побои by somebody
cloute - наносить легкие побои
clue - исследование
clung - цепляться
clutch - сжимать
coal - уголь
coat - пальто
cobble - мостить (cobbled street) мощеная булыжником улица
coconut - кокосовый орех
codswallop - глупости
coil - кольцо
collapse - складываться
collar - ошейник
come in handy - становится полезным
come round - очнуться
comfort - гл. утешать
commit - отважиться
committe - нарушить???
compartment - купе (вагона)
complain - возмущаться, брюзжать
compliance согласие, соблюдение
complicate - составлять ( усложнять )
comprehensible постижимый доступный для понимания
comprehensive всесторонний исчерпывающий
compulsory обязательное (правилом, законом)
concerne - сосредоточиться
concrete - бетонный
condemnation *
conduct - дирижировать
confuse - путать, отвлекать
conjure - наколдовать, вызвать
consider - признать
console - гл. утешать, сущ. консоль
contempt презрение, неуважение
conventional *
conversation беседа, диалог
convey передавать сообщать транспортировать
convince - убедить
convince - убеждать (cause (someone) to believe firmly in the truth of something.)
convince убеждать
cope *
cork - пробка
cough - кашель
cough - кашлять
could bear - вынести (перенести пережить)
council - городской совет
counter - прилавок??
couple - несколько, пара примерно
court noun суд корт
court verb ухаживать
coward - трус
cower - укрывать
cozy - уютный
crack - щель
crackpot - чокнутый
cradles *
craining - кранировать
cramm - рассовать (по карманам)
crawl - лазать
creak - скрипнуть
credulous доверчивый
creep - пугать
crept - красться, подкрадываться
cringe съежиться (от страха)
crinkle - сощурить
crisply - твердо
croak - гаркнуть
crooke - крючить
crouch - прижаться, пригнуться
crowd - компания, окружение, толпа
cruel - жестокий
crumpet - пышка
crumple - смять, свернуть, сложить
crunch - хрустеть
crutche - костыль
cupboard - чулан
curb сдерживать
curious - любопытно
curiously - причудливо
curle - сложиться
curle around - обернуться
curle up - свернуться
curricula - учебный план
curse - проклятие
curtain of ivy -завесь плюща
cushion - подушка
dabb - ткнуть несильно и неглубоко
damp - сырой
dangle - свисать
dare - решиться
dart - податься forward for example нестись
dash - мчаться
daze - обалдевать
deafening - оглушительный
deliberately умышленно, нарочно, целенаправленно
delicious - великолепно
delight - восхищаться
deliver - доставить
demand - требовально говорить
dense - густой ( лес )
dentist - дантист
deplore порицать, считать предосудительным
depressing - угнетающе
derision осмеяние
deserve - заслужить
desire - желание
detention - наказание
devotion - преданность, лояльность
dimple - покрываться морщинами
disappear - пропадать
disdain презрение
disgust - возмущение
dismay *
disposed *
disseminate *
distracte - отвлекаться
dive - погружаться, пикировать
dive - погруз
divulge разглашать (тайну)
doll - скучный
doorknob - дверная ручка
doormat - коврик перед дверью
dormice - садовая соня??
dormitory - спальня
doughnut  - пончик
downpour - ливень
dozen - дюжина
draft - зелье ?
draft - морозить
draught - напиток
draw - тянуть?
drawl - гнусавить
drawling voice - гнусавый голос
dreadlocks - кудри
dream up - выдумать
drench - собрать
drew - пододвигать
dried - сушеный
drift - дрейфовать (двигаться сам по себе)
dripp - заливать
drive out (of mind) - вытеснить (из головы) 
drone - гул
droole - слюнявить
drop - бросать
drop - капля
drow - тонуть 
drumm - стучать
dud - фальшивка
duffer - тупица
duly должным образом, правильно
dump - швырнуть
dunderhead - болван
dunno - don't know
dwell - витать ( in dreams )
eager - стремится, жадниться??
eagerly - очень охотно, жадно
earn - получать, (причинять? навврядююю)
earnest серьезный
ebony - черное дерево
eel - угорь
eerie - жуткий
effort - усилие
elbow - локоть
elicit выявлять добиваться извлекать
eloquent красноречивый выразительный
embarrassed - неловкий
ember - уголек
emerge - попадать в область
enchantment - заклинанье на вещах
endeavored *
enrage - приходить в ярость
enraptured *
ensnare - застилать
envelope - пакет, конверт
evocative вызывающий воспоминания
evoke вызывать
exact - точный
exasperate - сердиться
exasperate раздражать
excitedly - восторженно, явно
excitement - восторг
exciting - привлекательный, достопримечательный
excruciatingly мучительно
excuse - повод
exercise - прогулка??
exhauste - измотаться
exhaustive исчерпывающий
expletive матерно
expression - выражение
extent - the area covered by something., экстент, степень
extrication *
eyebrow - бровь
eyed - рассматривать
fabulous - дивный
facilitator посредник
faint - ослабнуть, упасть в обморок
faintly - слабо, обморочно
fair - справедливо unfair - несправедливо
fair - ярмарка
falter - запинаться
fame - величие, известность
fancy - забавно
fang - клык
fascinate - поражать воображение
fasten - застегнуть
fastening - застежка
faux pas (фо па) нетактичный или некрасивый поступок
feast - празднество
feather - перо (маленьекое)
feeble - неправдоподобный
feed - кормить
feign симулировать притворяться
fell asleep - уснул
fence - оградка?
fervent пылкий, страстный
festoons - гирлянда
fetch - забрать, приводить
fiddle - теребить
fidget - ерзать
fierce - яростный
filthy - грязный
fir tree - елка
firmly - твердо [сказал]
fishy - странное
fit - вмещать
fit up - примерять одежду
flagg - мостить
flaile - размахивать
flank - бок
flar - плоский
flat - грубый
flatt - льстить, сливаться (с поверхностью)
flatten - разгромить, разрушить, продуть, проиграть
flattering voice -вкрадчивый голос
flavor - вкус
flick - мелькать,отщелкнуть, щелкнуть
flight - полет ( пролет ( о ступенях )
flinch - вздрогнуть
fling - обхватить
flitt - перемещаться
float - плыть
flock - стая
flop - шлепок
flounder камбала барахтаться путаться
fluffy - пушок
flung back - запрокинул
flush - воодушевляться
flutt - трепыхаться, порхать
fond - предпочитать, любить
footstool - скамья
for a change - для смены, в кои то веки
forecast - предвещать
forehead - лоб
foul - нарушение, вина
foul stench - вонь
frantic - неистово
freak - выродок
freckle - веснушка
fret - размышлять
fright - боятся
fright страх, испуг, страшилище, пугать, тревожить
frost - иней
frown - негодование, хмуриться
fry - жарить
frying pan - сковорода
fudge - тянучка
fudge состряпать
fudging жульничество
fugitive беженец, беглец
fume - приходить в ярость
fumes - дымок
funeral - похоронный
fungi - гриб
furiously - яростно
further - дальнейшее
fuss - суетиться
galoshes - галоши
gamekeeper - егерь
gangling - подвижный
gap - щель
gape - любоваться
gasp - заикаться, открыть рот от удивления(охреневать??)
gather - собрать
gave him the thumbs up - показал большие пальцы поднятые вверх
gawk - таращиться
gaze - охренев смотреть во все глаза (gaze open-mouthed смотрел открыв рот)
gently - нежно, бережно
get a grip - успокоить
getups - одежка
gibb - издавать нечленораздельные звуки
git - дурак
give yourself a little shake - заставить себя встряхнутся
glance - взгляд
glare - глядеть
glass - стекло, бокал?, очки?
gleam - блестеть
glee - ликовать
glimpse - вид
glint - сверкать
glistening - блестящие
gloatingly - радостно
globe - глобус
gloom - сумрак
gloomy - мрачно, невзрачно
glow - вспыхнуть
glue - клей
glumly - угрюмо
goal post - ворота
goat - козел
goblet - кубок, чаша
goggle - слон???
going into the matter - вдаваться в подробности
good-for-nothing  - никчемный (о человеке)
goose - гусыня, гусь
gossip[слух] away - стрекотать?
got a lot to live up to - есть на кого равняться 
grandfather clock - напольные часы
grapple - вцепиться
grasp - сжать
grate - очаг
greasy - с проседью
grim - мрачный
grin - типа улыбка (нятянутая ухмылка) читается как "грын"
grind - скрежетать
grip - хват
groand - стонать
groom грум конюх ухаживать за шерстью (животного) готовить кого-то к чему-то  определенному
grope - схватиться
growle - ворчать
grubby - невзрачный
grudgingly - неохотно
gruffly - грубовато
grunt - бурчать, хмыкнуть
guess - догадываться, предполагать
guff пустая болтовня
guilty - виноватый
gulp - глоток
gush сильный поток / фонтанировать
hag - вурдалак
ham - окорок
handkerchief - носовой платок
hang glider - планер
Hang on - заходите
hanger - вешалка
hap удача, фортуна; случаться
harbor - гав ань
harness - упряжь
harp - арфа
hatch - вылупляться
have a go on something - поиграть на чем то
having a tantrum - впадать в безумие (о детях)
haze дымка, легкий туман
he did'nt was AJECTIVE at all  -  несмотря на все он не был ПРИЛАГАТЕЛЬНОЕ
headmaster - директор
headmistress - директрисса
heap  - куча
heart gave a leap - подпрыгнуло сердце
heartstring - жила???
heave - толкать
heel - пятка (каблук), поводок?
Hence *
hence adv следовательно, затем
herb - трава
here, of all places - именно здесь
hesitate - медлить
hing - петля
hiss - шипеть
histrionics театральность, неестественность
hitch - препятствие
hobble - ковылять
hog - кабан
hoiste - сдвинуть
hold no sign at all - не иметь ни одного знака
hold with - соглашаться
holly - остролист
hood - капюшон
hoodlum - безумец
hoop - обруч
hoot - ухать ( о совах )
hoov - копыто
hopp - спрыгнуть
horny - ороговевший
hover - парить, подняться, сравняться
howl - вой
huddle - группа, компания
huffy обидчивый
hugg - обнять hugg around the middle (обнять посредине)
hullaballoo ажиотаж
human made human - ктото заставляет кого то чтото
humm - напевать
hunch - горбиться
hunger - голод
hurtle - пронестись
hushed voice - приглушенный голос
hut - хибара
hypocrisy лицемерие
ice pop - эскимо
idiosyncrasy черта характера, особенность стиля
imminent нависший about to happen
impatiently - нетерпеливо, раздраженно
impeccably безукоризненно
imply подразумевать, означать
impose навязать, наложить
imprecise - неточный
in broad daylight - средь белого дня
inclined слонный, предрасположенный
inclusive *
indulge предаваться
ineptitude неумение
inferior adv низший, худший
inferior noun подчиненный, младший по чину
infusion - настой
inhibition - a feeling застенчивость сдержанность скованность(!)
injure - нападать
innocent - невиновный
insist - утверждать
instance *
instead - вместо
insular островной, замкнутый
insult - оскорблять
intently - внимательно
interfere - ввязаться, пересечься
interfering - навязчивый, докучливый
invent - изобретать
investigation - расследование
invigorate бодрить укреплять
involve - вмешиваться, включать в себя
irritably - раздраженно, досадно?
it have something to do with - по причине
itch *
jabb - протянуть
jacket - куртка
jar - банка
javelin - копье
jealousy - зависть
jerk - двинуть чтото рывком?  (jerk head around - быстро повернуть голову)
jinx - заклинать
jolt - скачок
jostle - задевать
judge - судить judging (судя)
judiciously рассудительно
keep your hair on - не разоряйся ты так
kettle - котелок
knee - колено? (коленная чашечка)
knickerbockers - панталоны
knitt - вязать
knobbly - узловатый
knuckle - костяшка пальца
laborious трудоемкий
lace - кружевной
lade нагружать грузить
lamb - баранина
lane - луг
lantern - фонарь
lap - колено? (передняя поверхность от бедра до колена)
lawn - лужайка
lazily - лениво
lean - наклонить свое тело (back - отклонить, across - через что то  и т.д., against - о бо что то) 
leap - приступ
leapt - ??отшатнуться??, вскочить on his feel
learn something by heart - выучить наизусть(назубок) 
ledger - конторская книга
leisure досуг
lent - ссудить (дать в долг)
lets somebody down - подставить
lick - лизать
lid - крышка
limp - хромать
linger - скользнуть
lip - губа
lit up -  освещать
literacy *
loath - злобно разыгрывать???
locker room - раздевалка
look after - присматривать за
loom - выныривать
loop-the-loop - мертвая петля
luggage - багаж
lullaby - колыбельная
lumber - оглядываться
lump - ушлепок, ублюдок, хлюпик и т.д. ( ШИШКА !!! )
lumpy - продавленный, бугристое
lurch - урчать, нырок??
lurk - укрываться
made for somebody instead - предпочитать когото вместо кого то
magnanimity - великодушный
mahogan - краснок дерево
make out - выяснить?
manage - управиться, суметь
mane - грива, копна 
mangle - изодрать
mantelpiece - каминная полка
maple - клен
marble - мрамор, грецкий орех
march - маршировать, двинуться
maroon - свекольный (цвет)
match - комбинация, спичка
mauve - розовато-лиловый
mean - злой
mean - иметь в виду
meanwhile - по ходу дела, между тем
measure - мерить 
meddle - ввязываться
melt - растворить, расплавить
mend - починить
mention - упоминание
merit заслуга
merrily - радостно
mesmerize гипнотизировать
middle fork - средний на развилке(растройке)
miffe - надуться ( обидеться??, копить злость, обиду ) 
minuscule - миниатюрный
minutiae мелочи детали
miserable - несчастный
mistletoe - канитель
mixing with - (о людях - яшкаться, пересечься)
moan - жаловаться, отчаиваться и стонать от этого
moldy - плесневелый
mole - крот
mood - настроение
mossy - мохнатый ( покрытый мхом )
moth - моль
mound - россыпь
mount - седлать??
muddy - грязный
muffled voice - сдавленный голос
mug - кружка
mumble - мямлить
murmur - бормотать
mustache - ус
nag - нудить
nagg - занимать ( мысль )
narrow - сузить
nasty - гадкий
neat - аккуратный
neatly - аккуратно
needle - игла
neglect пренебрегать
neighbor - сосед
nerve (the) of him - наглость его. дословно
nerviosly - нервно
nettle - крапива
nibble - теребить
noble - благородный
nocuous вредный ядовитый
nodd - кивнуть
nosebleed - кровотечение из носа
nostril - ноздря
nosy - надоедливый
notion *
notion понятие, идея; позыв, намерение; приспособление
nurse -  главврач
oaf - придурок
oak - дуб
obeisance *
oblige обязать
obliging услужливый
obscure неясный 
observe - наблюдать
obviously - просто, тривиально, старо
occasion - случай
oddly - странно
offend - обидиться
offer - предлагать
omen - примета, презнаменование
on the contrary - напротив(контраргумент)
ostentation хвастовство (состоянием и роскошью)
ought - быть должным
ounce - унция
outrage - неслыханно
overtake  - обогнать
owe - быть должным
pace - ходить кругами по комнате
painful - жалкий
paisley - мятый
pajama - пижама
palm - ладонь
pant - запыхаться
parade - вышагивать, расхаживать
parcel - сверток, коробка
parchment - пергамент
part - раздвигать
particularly - особенно, очень
pass - пропускать, прогтягивать
passersby - прохожий
patt - опустить, похлопать
pavement - мостовая, дорожное полотно
paving stone - могильная плита
peas - горох
pebbles - галька, щебень
peck - чмокнуть  (in a cheek)
peculiar - странность, необычное
peculiar своеобразный, специфический
peel - облуплять (яйцо)
peer - взглянуть
pelt - закидывать (вопросами и не только)
pep talk - вводная речь
peppermint humbugs - мятная жевачка
perch - приткнуться 
perform - накладывать
persistence настойчивость упорство
persuade - вразумить
pervasive *
pervasive распространяющийся
perverse извращенный
petrife - запугать до смерти, ДО ОЦЕПЕНЕНИЯ!!!
pewter - латунь
pheasant - фазан
phial - пробирка?
pick out - выбирать
pickle - заспиртовать
pick-me-up - стаканчик
pier - пирс
piercing - пронзающий
pigtail - хвостик, волосы а ля конский хвост
pile - гора
pile - нагребать
pillow - подушка
pin - уколоть, подколоть (тонкий укол)
pinch - щипать
pineapple - ананас
pinprick - след от укола, крошечная точка
plain - ясно, понятно, обыденно?
plain work - повседневная (одежда)
platitude банальность пошлость
plausible правдоподобный
plenty - множество
pliable - устойчивый
plott - строить планы
plow - плуг
plump - толстая, полная
plunge - катиться
poke - ткнуть, высунуть
poker - вертел
pole - шест
pompously - важно
Poor bloke - бедняга
popkin - пупсик
porcupine - дикобраз
pork - свинина
porridge - овсянка
portent знамение предзнаменование предупреждение
possession - владение
potion - снадобье
pouch - мешочек
pound - стучать
pound - фунт
pour - посыпать
practice session - тренировка
praise хвалить
preach проповедовать, поучать
predilection пристрастие склонность
premise предпосылка
presice *
presume предположим, допустим
prick - мурашка :) (a back of neck was prickled - по шее побежали мурашки )
prig воровать
prig педант, формалист
prodd - пихать, тыкать пальцем
profit - польза
profound ad глубокий(образно)
prompt ad незамедлительный быстрый
prompt adv быстро точно
prompt noun подсказка напоминание
prompt verb подсказывать вызывать побуждать
prone *
pronouncements *
prophet - пророк
provoke - провоцировать
pry подглядывать
puff - затягиваться, сопеть
puff balls - развод (грязи) на одежде
pulled out - вытянул
pumpkin - тыква
puncture - пробоина(маленькая?)
pundit эксперт
pupil - ученик
purse - cжать, прижать
put together - взятые вместе
quail - спасовать
queasy - тошно
quietly - тихо
quill - перо большое
quilt - одеяло
quirk verb каламбурить, насмехаться, язвить, ехидничать, неизменно
quirk индивидуальная особенность, каприз
quirk каламбур
quite - абсолтютно
quite - совершенно, довольно?
quite *
quiver - вибрировать
quiver - колчан
quivering voice - дрожащий голос
quiz show - викторина
racket - возня
rag - тряпка, рвань, лохмотье
ragg - драть
rapp - долбить, барабанить
raspberry - малина
rasping - скрежешущий
rather - довольно
rattle - испугаться, оттягивать, скорее всего имеет кучу значений
ravine -пропасть
reach - достигать
reached out - протянул [руку]
realize - понять
rear - шествие
rebellion - восстание
recent - современный
reciprocity взаимность
recitation декламация изложение
recite - воспроизводить
reckon - ректор
reckon - считать, утверждать (do not reckon - не понимать)
reckoned *
reel - повторять
refugee беженец
refuse - отказываться
regard noun внимание, отношение
regard verb считать рассматривать относиться
rejoice - возрадоваться
relactant неохотный
relief - облегчение
reserve резерв; сдержанность
reveal - открыть скрытое доселе
revenge - возмездие, кара, месть
revile поносить оскорблять
revolt - отвращать
rib - ребро
ribbon - лента
ride - поездка верхом(??)
rider - наездник
riffraff - оборванец
rigid - цепенеть
rip - шов
ripp - сдирать, колыхаться???
rival соперник конкурент противник
roar - рев
roast - жарить
rob - красть
roll call - список для переклички
rott - гнить
rough - грубить
row - гребсти
rubb - потирать
rubber - резина
rubbish - чушь
ruddy - проклятый, мерзкий
rude - грубый
rue сожалеть, печалиться
ruffle - взъерошивать, ошарашен?
ruffle - вспенить? зарябить
rugs - половички, коврики
rumbling - рычащий, громыхающий
rummage - ковыряться, шарить
rumor - молва
rush - уволочь
rustle - шуршать
sacrilege святотатство кощунство
sagg - пргибаться
saturation *
scarlet - алый
scatter - насыпать
scent - предчувствовать
scoff издеваться
scoop - горсть
scorn презрение
Scotch tape - cкотч
scowl - скривиться, хмуриться
scramble - вскочить
scratchy - царапающий, чешущий
scrawl - почерк
scrawny - сухопарый, тонкокожий?
screech - визжать
screw up - собрать, сморщить
scribble - нацарапать (записку) делать записи 
scruff - загривок
scruple сомнение колебание (перед возможно плохим поступком) колебаться сомневаться
scrutiny *
scudd - наплывать
scurry - шастать
scuttle back - ретироваться
seal - печать
seaweed  - водоросли
seep - растекаться
seize - схватить
selfish - эгоистично
set someone on someone натравить
severe - строго
shabby - невзрачно
shack - хижина
shaggy - косматый
shave - опастность
shear - сбривать
shed - сарай
shed пролить
shed сарай, навес
sheer явный, отвесный, полнейший, отвесно
sheets - простыни, одеялы
shell - лущить ( горох, орехи ? )
shimmer - мерцать
shiver - дрогнуть, передернуться
shoulder - плечо
shout - кричать
shove and heave - протискивать
shovele - запихивая
shreder - измельчить
shriek - верещать
shrill voice - пронзительный голос
shrink - сжаться в комок, уменьшиться
shrivel -сморщиваться
shudder - содрогаться
shuffle - тащить
shuffling his feet - переминаясь с ного на ногу
shut - закрыть
sideways - косой, боковой
sigh - знак, вздох
silly - глупый, дурацкий (о вещи)
simmer - кипеть
sincerity искренность
sink - плита?
sink - раковина
sink - рухнуть
sippe - цедить
sit with back to - сидеть спиной к  sat with his back to window (сидел спиной к окну)
sizzling - жарящийся
skid занос
skimm - пролистывать
skinny - тощий
skipp - подпрыгивать, перепрыгивать
slamm - хлопнуть
sleek - гладкий
sleeve - рукав
slender - изящный
slid - стряхнуть
slide - скользить
slightly - слегка
slightly burn - поджаренный
slimy - склизский, желеобразный
slink - прошмыгнуть
slipp - убрать? оступаться
slippers - тапочки
slit - щель ???
slither - ползать
slither скользить, ползти
slop - удалится, наклониться
slope - склон
sloppy небрежный неряшливый
slouche - втащиться
slug - слиязняк
slug pellet - моток веревки
slump - склониться 
smarten yourselves up - привел себя в порядок
smirk - ухмыляться
smudge - пачкать
smuggle - пронести (тайно)
snapp - резко сказать, бросить фразу, !сломать ! , щелкать ( клювом ), срываться
snapped it in half - сломать пополам
snare - силки ( для ловли птиц )
snarle - огрызаться, кривить
snatch - схватить, вырвать
sneaker - тренировочные штаны
sneer - презрительно говорить
sneeze - чихать
sniff - шмыг [носом]
sniff around - принюхайся
sniffly voice - высокомерный голос
snigger - хихикать
snivele - хныкать
snooze - дрыхнуть
snore - храпеть
snout - пятачок (pig S. -поросячий ), рыло
snuffbox - табакерка
snuffle - сопеть
soar - спускаться
sobb - всхлипнуть
solemn торжественный серьезный формальный
soothing успокаивающий
sore - ссохнуться
spat - велеть?, плюнуть?
specimen - экземпляр
speck - пятнышко
spectacles - очки
spell - заклинание устное?
spill - разливать
spindly - плетеный
spine - хребет
splatter - стекать
spleen - перепонка
splendid - прекрасный
spoil - испортить
sprang - вскакивали ( волдыри )
sprawle - приземлиться
spread - намазывать
springy - упругий
squash - сплющивать
squashy - мягкий, сминаемый
squat - низенький, плотный???
squeaky voice - скрипучий голос
squeal - визг
squeamish брезгливый щепетильный 
squeez - душить, протискиваться, придвинуться together друг к другу??
squid - кальмар
squint - вглядываться
stabb - пронзать
stack - стопка
staff room - учительская
stagger - метаться
stain - пятно
stalking beast - хищный зверь
stammer - проикать (заикаться действительно!)
stamp - марка
stand-offish чопорный сдержанный холодный нелюдимый
stare - уставится
startle - озадачиваться
startle verb напугать, сильно удивить
startling поразительный
starve - морить голодом //помирать с голоду
steadfast ad твердо, прочно, верно, преданно, непреклонно, 
steadily - монотонно
steady - прямо
steel - взвинчивать ( себя или других)
steep - крутой, резкий
steeply - резко
steer - вести ввести() управлять
steering wheel - рулевое колесо
stern - пристальный (stern look - пристальный взгляд) суровый
stick - клеить??, торчать
sticky - увесистый
stiff - коченеть
stiffly - сухо, чопорно, неподвижно
stirr - помешивать
stitch - вышивка
stoat - черствый
stoke - подкладывать дров в огонь ???
stomach - живот
stood on tiptoe - встал на цыпочки
stood rooted to the spot - врос в землю
stool - стул
stove - духовка, плита
strain - напрягать
strande - торчать
strap - лямка
straw  - соломенный
stray - коситься, блуждать
streak - пуститься
stretch - потягивать, растягивать
strictly - строго
string - связка, струна
stripe - полосатить
stroke - теребить
struggle - бороться
stub - зачаток?
stumble - пятиться, спотыкатся
stump - tree ( пенек )
stump - остолбенеть
stunt - показуха, акция
stutter - заикаться
subliminal *
substance - вещество
substitute - подмена, смена
subtle - изысканный
suck - втягивать, всасывать
sundry всякий разный
supple - податливый
suppose - допускать
surge - вернуться?
surge (от латинского surgere 'to rise') to move quickly and with force in a particular direction / фонтанировать 
suspension - подвешенный
suspicious - подозрительный
swagger - выступить ( из толпы например )
swallow - сглотнуть, проголотить
swarm - рой, улей
swarming - толпится
swarthy - смуглое (лицо)
sway - схватился
sweep - мести
swell - перерости (о звуке), надулся (о возд. шаре)
swift - быстрый?
swig - глоток
swipe - замах
swish - рассекать
swishly - хлесткий
swooping - пикировать
sworn - разобрал
swung  - (swung round - круто развернуться) вращать? open - распахнулась свалиться
syllable - слог
tabby - полосатая (о кошке)
tacit молчаливый, подразумеваемый
tackle - вступать в единобортво
tailcoat - фрак
tame - приручать
tangle - прядь
tangle - свисать
tap - кран ( в ванной )
tape - барабанить
tape - лента
tapestry - гобелен
tartan - клетчатый
taunt - издеваться
tawny - темно-рыжий-коричневый
tea cozy  - подставка для чайника
tear-streaked - заплаканное
tease дразнить
tedious утомительный скучный too long
temper - терпение
tendril - отросток, побег
tent - дать
tentacle - щупальце
term - семестр
thespian театральный трагический
thick - густой, толстый (о слое)
thirst - жажда
thrall - рабство, рабский, порабощать
threaten - угрожать
throat - горло
throng - переполнять
throughout - вокруг
thud - глухой ( звук )
thud - глухой звук 
tick - подступать
tickle - дергать
tidy - аккуратный
tight - плотный
timidly - застенчиво
tin - жестянка 
tinge - оттенок
tingle - (ис/на) ? полнять 
tinned - законсервмрованный
tip - цитата
tipp - ссыпать, настучать ( кому либо ) off
tiptoe - передвигаться на цыпочках
to be nursed back to health by somebody - выхаживаться кем-либо
to get rid of - избавиться от 
to pull himself together - взять себя в руки
tongue - язык
topple - приземлиться
tore - оторвать, убрать
torment *
torture - пытка
trail - волочь ( по земле )
trammel - препятствие
transgression нарушение, проступок, грех
trash can - мусорный ящик
treat - лечить
trick - надувать, обманывать
tricky customer - клиент с запросами
tripe - требуха
tripp - споткнуться
tripping over спотыкаться
trodden ad проторенный
trophy - трофей
trousers - штаны
trowel - корзинка
trudge - идти
trunk - сундук, tree T. - ствол дерева
tub - лохань
tuck - заткнуть
tuft - челка
tugg - дергать
tune - мотив
turkey - индейка
turn out - выяснить
twig -  прут
twiste - ??:?круто поворачивать, извиваться
twitch - вздрогнуть
tyke - шалун (о детях litle tyke), безобразник 
umbrage обида
undue несвоевременный чрезмерный
unknown relation - неизвестный родственник
unwitting невольный, неосознанный
upset - расстроеный
urge побуждение
urgent - срочный, важный
urgently - настойчиво
usher - проводить кого-либо
utter абсолютный полный
utter произносить, выражать
utterly крайне, абсолютно
vacuum - пылесосить
vain - мука ( worst??  that pain )
vanishe - исчезать
vapor - пар
vast - громадный, просторный
vaunt хвастать
vaunted хваленый
vicarious чужой заместительный
vicious - злобный, опастный
victim - жертва
vigorously - энергично, остервенело
waddle - проталкиваться, пробираться
waffle - болтовня
waft - распространяться, носиться
waggle - приподнять
wail - хныкать
waist - туловище
wake with a start - проснутся подскочив
walnut - кокосовый орех грецкий орех???
wand - волшебная палочка
wart - бородавка
warty - гадкий
was about - был примерно 
wax - воск
weave - лавировать
weed - сорняк
weigh - взвешивать
weirdo -  неестественный, извращенец
whack - лупить
wheel - катить ( about cart )
wheeling around - вылез вперед
wheeze - нудить, хрипеть
whimper - хныкать, бормотать
whine - велеть
whipp - хлестать
whirl - крутить
whisker - ус (у живоного)
whiskery - щетинистый
whisper - шептать
whittle - вырезать
wig - парик
willow - ива
wince вздрогнуть
wink - подмигнуть
wipe - вытирать
with an air of great surprise - с большим интересом
wool - шерсть
work out - разобрать (разобрать бред)
would have been wild to - не отказался бы от того, чтобы 
wound - путаться, шнырять
wranch - прокладывать, пропихиваться
wrench - вырываться
wrestle - впихивать
wriggle - изгибаться?пищать?
wrinkle - зажимать??, морщиться??
wrist - запястье
wrought-iron - чугун
yawn - зевать
yell - наорать
yew - тис (дерево такое)
zeal усердие рвение
zealot фанатик
